#
..................................................................................................................................
..................................................................................................................................
..................................................................................................................................
..................................................................................................................................
..................................................................................................................................
................DDD...............................................................................................................
................DDD...............................................................................................................
........DDD..DDDDDDDDD............................................................................................................
........DDD..DDDDDDDDD...............Z............................................................................................
CCCCCCCCCCCCCCCCCCCCCCCCCCCCCCCCCCCCCCCCCCCCCCCCCCCCCCCCCCCCCCCCCCCCCCCCCCCCCCCCCCCCCCCCCCCCCCCCCCCCCCCCCCCCCCCCCCCCCCCCCCCCCCCCCC
#
......................................................F...................F......................F.........F..................D...
...........................................DDD........F...................F......................F.........F..................D...
.........................................DDDDD........F..................DF......................FD........FD.................D...
...............DDD.....DDDDDD....DDDDD.....DDD.....F..FDDDD...........DDD.F..FDDD................F...DDDF..F.....DDDD.........D...
...........................................DDD.....FFFF...................FFFF................F..F......FFFF..................D...
...........D...............................DDD.....FDDD....DDDD.........DDDDDF................FFFF......FDDD..................D...
...........................................DDD.....F.........................F....N...........FDDD......F.....................D...
..............DDD..........DDD.............DDD.....F..............DDD........F................F.........F...........DDD.......D...
..............DDDG........HDDD...........P.DDD.....F..............DDD........F................F.........F...........DDD.....Z.D...
CCCCCCCCCCCCCCCCCCCCCCCCCCCCCCCCCCCCCCCCCCCCCCCCCCCCCCCCCCCCCCCCCCCCCCCCCCCCCCCCCCCCC...............CCCCCCCCCCCCCCCCCCCCCCCCCCCCCC
#
..................................................................................................................................
..................................................................................................................................
..................................................................................................................................
..................................................................................................................................
..................................................................................................................................
................DDDDDD............................................................................................................
............R...DDDDDD...........................................DD...............................................................
........M.......DDDDDD...........................................DD...........................................CC..................
....R...........DDDDDD.........................................DDDDDD.........................................CC....Z.............
CC..............CCCCCC...O.JJJ...O.JJJ....CCCCCCC..O.JJJ.....CCCCCCCC.O.JJJ..CCCCCC..I..............CCC..CCC..CC..CCC.............
#
..................................................................................................................................
..................................................................................................................................
..................................................................................................................................
..................................................................................................................................
..................................................................................................................................
..................................................................................................................................
................R..M..............................................................................................................
..........R..M....................................................................................................................
....R..M..........................................................................................................................
CCCCCCCCCCCCCCCCCCCCCCCCCCCCCCCCCCCCCCCCCCCCCCCCCCCCCCCCCCCCCCCCCCCCCCCCCCCCCCCCCCCCCCCCCCCCCCCCCCCCCCCCCCCCCCCCCCCCCCCCCCCCCCCCCC